P
5
#####
# @@#
#B# #
# A #
#####
