P
8
########
########
#  #  @#
#@B   B#
# A#   #
## @####
########
########
