P
12
############
############
###@  ######
###   BB A##
###B ###  ##
### #@@@# ##
##  #@@@# ##
# B   B  B #
#      #   #
########   #
############
############
