P
8
########
###a ###
###b ###
### #@@#
##  ## #
##  d  #
######@#
########
D
4
####
#  #
   #
## #
