P
6
######
#  ###
#@bD##
# a###
## @##
######
D
5
#####
#   #
    #
#   #
#####
