P
7
## ####
## ####
# a@# #
    p #
#   #@#
#  d###
#######
D
5
## ##
#   #
# t #
#   #
#####
T
6
######
### @#
#   ##
  ####
######
######
